####################
#E!!!!!!!!!!!!!!#!!#
#!###!###!#!#!#!#!##
#!!!!!#!!!#!#!#!!!!#
#!###!#!#!!##!#!####
#!!!!!!!#!!!!!!!#!!#
#!###!!##!#!#####!##
#!!!!!#!!!#!!!!!!!!#
#######!!##!#!###!##
#!!!!!!!!!#!#!!!#!!#
#!##!!###!#!#!####!#
#!!!!!!!#!!!!!!!!!!#
#!#!!!###!#!#!###!##
#!#!!!#!!!#!!!!!#!!#
###!###!###!#!#!#!!#
#!#!!!#!#!#!!!#!#!!#
#!#!#!#!!!#!#!#!#!##
#!!!!!#!!!!!!!#!!!S#
#!#!#!#!!!#!#!#!!!##
####################