##################################################
#E!!!!!!!!!!#!!!#!!!#!!!#!#!!!#!!!!!#!!!#!#!!!!!!#
#!#!#!!!#!###!#!###!#!#!#!!##!#!#!###!#!#!#!!!#!##
#!#!!!#!!!!!!!#!!!#!#!#!#!#!!!#!!!#!!!!!#!!!!!#!!#
#!##!!##!##!#!#!#!#!#!#!#!#!###!!##!#####!###!#!##
#!#!#!#!!!!!!!!!#!#!#!!!!!#!!!!!!!!!#!#!#!!!#!!!!#
###!#!###!!##!###!#!####!!#!#!#!#!!!#!#!#!###!#!##
#!!!#!!!!!!!#!#!#!!!!!!!#!!!#!#!#!#!!!!!#!!!!!#!!#
#!!##!#####!#!#!!####!!!###!####!!#!!##!#!###!##!#
#!#!!!#!!!!!!!!!#!!!!!!!!!!!!!!!!!!!#!!!!!#!!!!!!#
#!#!#####!#!###!!####!!!##!##!#!###!#!#!######!###
#!!!!!!!!!#!#!!!#!#!!!#!!!#!!!#!#!!!!!#!#!!!#!!!!#
###!#!#####!#!#!!!###!##!!####!#!###!!###!#####!##
#!!!#!#!#!!!!!#!!!!!!!#!!!!!!!#!!!!!!!!!#!#!!!#!!#
####!!#!#!#!###!#######!#####!!!###!#!###!###!#!##
#!!!!!!!!!#!!!!!!!#!#!#!!!!!#!#!!!!!!!!!#!!!!!!!!#
#!##!!#!##!!#!###!#!#!#!#!#!#!!!#!!!###!#!#####!!#
#!#!!!!!!!!!#!!!!!!!#!!!!!#!#!!!!!#!!!!!!!!!!!#!S#
#!#!#!#!#!#!!!#!!!#!!!#!#!#!#!#!#!!!#!#!#!#!#!!!##
##################################################
