##################################################
#!#!!!#!#!#!!!!!!!!!#!!!#!!!!!#!#!!!!!!!#!#!!!!!!#
#!###!#!#!!!###!#!###!!!#!#!###!#####!###!#!######
#!!!#!!!#!#!!!!!#!#!#!#!!!!!#!#!!!!!#!!!!!#!!!!!!#
#!#!#!!!!!#!#!!!!##!#!!!#!#!#!#!#!#!#!#####!###!##
#!#!!!!!#!!!#!#!#!!!!!!!#!!!#!!!!!!!!!#!!!#!!!#!!#
#!!!#!###!#######!#!##!!!##########!#!###!###!#!##
#!!!#!#!#!!!!!#!!!!!!!#!!!#!!!!!!!!!#!!!!!!!#!!!!#
#!###!#!!#!!#!#!#!#####!##!!###!!!#!#!#!#!###!!!##
#!#!#!!!!!!!!!!!!!!!!!!!#!!!!!!!#!#!!!!!!!!!!!#!!#
#!#!#!#!#!#!###!#!!#!##!####!##!#!#!#!#!#!####!!!#
#!!!!!#!#!!!!!#!#!#!#!!!!!!!!!#!#!#!!!!!#!!!#!#!!#
###!!####!###!#!#!#!#!###!###!###!##!!#!##!!#!####
#!!!!!#!#!!!#!#!#!!!!!#!!!!!!!!!!!!!!!#!#!!!!!#!!#
##!!#!#!#!####!##!#!!##!#!#!###!#!#!#####!##!##!##
#!!!!!#!!!#!!!#!!!!!!!!!#!#!!!#!#!!!#!!!!!!!!!!!!#
#!#!#!###!!!#!##!##!#####!###!###!#!#!!!#!#!#!#!##
#!#!#!#!!!!!#!!!!!#!!!#!!!!!#!#!!!!!!!#!#!!!!!#!!#
#!#!#!!!#!#!#!#!!!!!#!#!#!#!#!#!#!#!#!#!#!#!!!#!##
##################################################
