##################################################
#!!!#!!!#!!!!!!!!!#!!!!!!!#!!!#!!!!!!!!!!!!!!!!!!#
###!!!#!##!!#!!#!##!#!#!#!###!!#!##!#!##!!#!###!##
#!!!!!!!#!!!#!!!#!!!!!!!#!#!!!!!#!!!#!#!!!#!#!!!!#
###!###!###!#######!###!#!###!###!#!#!#!#!#####!##
#!#!#!#!#!#!!!!!!!!!#!!!#!#!#!!!!!!!!!!!#!!!!!#!!#
#!#!#!!!#!#!#!#!#!###!!####!!#!!###########!!!####
#!#!!!#!#!!!!!!!!!#!!!#!!!!!#!!!#!!!#!!!#!!!!!!!!#
#!#!#!#!#!#!!!!!#!#!###!###!#!#!#!!#!!#!#!#####!##
#!#!#!#!#!!!!!!!!!!!#!!!#!!!!!#!!!!!!!!!#!!!#!#!!#
#!#!#!#####!#!###!#!#!!!!######!#!#####!!!#!#!####
#!!!!!!!#!!!#!!!#!!!!!!!!!#!#!#!#!#!!!!!!!#!!!!!!#
###!#!##!####!#!#!#!###!##!!#!###!#!#!#!#!########
#!!!!!!!!!!!#!#!!!!!!!!!!!#!!!!!!!#!#!#!!!!!!!!!!#
#!#########!#######!###!!##!!#!!#!#!#!#######!!!##
#!!!!!#!!!!!!!!!!!!!!!#!#!!!#!!!#!#!!!#!!!!!#!!!!#
#!###!##!#!####!###!#!#!#!#####!##!!!!#!#!#!###!##
#!#!!!!!#!!!!!!!!!!!!!!!!!#!!!!!!!!!#!!!!!#!!!!!!#
#!#!#!#!#!!!#!#!#!#!#!#!#!#!#!!!!!#!#!#!#!#!#!#!##
##################################################
