##################################################
#!!!!!!!!!!!!!!!#!!!!!!!#!#!#!!!!!#!!!!!!!#!!!!!!#
####!!#!#!###!#####!!!#!#!#!#!#!#######!#####!##!#
#!!!!!!!!!!!!!!!#!!!!!#!!!!!#!#!#!!!#!!!!!!!!!!!!#
##!########!!!!##!#!#####!#!#!#!#!#!#####!!#!#!###
#!#!!!!!!!#!#!!!!!!!!!!!#!!!#!#!!!!!#!!!!!!!!!#!!#
#!###!#!!#!!###!!!#####!##!!#!###!#!#!#####!###!##
#!!!!!#!!!#!!!!!!!#!!!!!#!#!#!!!!!!!!!!!!!#!!!!!!#
#!!!#####!###!#!#####!###!##!!#####!#####!###!##!#
#!!!!!!!!!!!!!#!!!!!#!!!!!!!!!#!!!!!!!!!!!!!#!#!!#
###!##########!##!!########!###!##!!#!!####!#!#!##
#!!!!!!!!!!!!!!!!!!!!!!!#!#!!!#!!!#!!!!!!!!!#!!!!#
#!#!###!#!#!!!#####!#!##!!#!#!#!###!#!##!####!!###
#!!!#!!!!!#!!!!!!!#!#!!!#!#!!!#!!!#!#!#!#!!!#!!!!#
###!#!#!#!#!#!##!!!####!#!#!#!###!#!!!#!!!###!#!##
#!#!#!#!!!!!!!#!!!!!#!!!!!!!#!!!!!!!!!#!!!!!!!!!!#
#!###!###!#!###!!#!##!#!#!#!#!###!###!###!!!#!####
#!!!!!!!#!#!#!!!!!!!#!#!#!#!#!!!!!!!#!!!!!#!!!!!!#
#!#!#!#!!!#!#!#!!!#!#!#!#!#!#!#!#!!!#!#!!!#!#!#!##
##################################################
