##################################################
#E!!!!!!!!!!#!!!#!!!#!!!#!#!!!#!!!!!#!!!#!#!!!!!!#
#!#!#!!!#!###!#!###!#!#!#!!##!#!#!###!#!#!#!!!#!##
#!#!!!#!!!!!!!#!!!#!#!#!#!#!!!#!!!#!!!!!#!!!!!#!!#
#!##!!##!##!#!#!#!#!#!#!#!#!###!!##!#####!###!#!##
#!#!#!#!!!!!!!!!#!#!#!!!!!#!!!!!!!!!#!#!#!!!#!!!!#
###!#!###!!##!###!#!####!!#!#!#!#!!!#!#!#!###!#!##
#!!!#!!!!!!!#!#!#!!!!!!!#!!!#!#!#!#!!!!!#!!!!!#!!#
#!!##!#####!#!#!!####!!!###!####!!#!!##!#!###!##!#
#!#!!!#!!!!!!!!!#!!!!!!!!!!!!!!!!!!!#!!!!!#!!!!!!#
#!#!#####!#!###!!####!!!##!##!#!###!#!#!######!###
#!!!!!!!!!#!#!!!#!#!!!#!!!#!!!#!#!!!!!#!#!!!#!!!!#
###!#!#####!#!#!!!###!##!!####!#!###!!###!#####!##
#!!!#!#!#!!!!!#!!!!!!!#!!!!!!!#!!!!!!!!!#!#!!!#!!#
####!!#!#!#!###!#######!#####!!!###!#!###!###!#!##
#!!!!!!!!!#!!!!!!!#!#!#!!!!!#!#!S!!!!!!!#!!!!!!!!#
#!##!!#!##!!#!###!#!#!#!#!#!#!!!#!!!###!#!#####!!#
#!#!!!!!!!!!#!!!!!!!#!!!!!#!#!!!!!#!!!!!!!!!!!#!!#
#!#!#!#!#!#!!!#!!!#!!!#!#!#!#!#!#!!!#!#!#!#!#!!!##
##################################################