##################################################
#!!!!!!!!!!!#!!!#!!!#!!!#!#!!!#!!!!!#!!!#!#!!!!!!#
#!!!!!!!!!!!E!!!!!!!!!!!!!!!!!#!#!###!#!#!#!!!#!##
#!#!!!#!!!!!!!#!!!#!#!#!#!#!!!#!!!#!!!!!#!!!!!#!!#
#!##!!##!##!#!#!#!#!#!#!#!#!###!!##!#####!###!#!##
#!#!#!#!!!!!!!!!#!#!#!!!!!#!!!!!!!!!#!#!#!!!#!!!!#
#!!!!!!!!!!!!!!!!!!!!!!!!!!!!!!!!!!!#!#!#!###!#!##
#!!!#!!!!!!!#!#!#!!!!!!!#!!!#!#!#!#!!!!!#!!!!!#!!#
#!!!!!S!!!!!!!!!!!!!!!!!!!!!!!!!!!#!!##!#!###!##!#
#!#!!!#!!!!!!!!!#!!!!!!!!!!!!!!!!!!!#!!!!!#!!!!!!#
#!#!#####!#!###!!####!!!##!##!#!###!#!#!######!###
#!!!!!!!!!#!#!!!#!#!!!#!!!#!!!#!#!!!!!#!#!!!#!!!!#
###!!!!!!!!!!!!!!!!!!!!!!!!!!!!!!!!!!!###!#####!##
#!!!#!#!#!!!!!#!!!!!!!#!!!!!!!#!!!!!!!!!#!#!!!#!!#
####!!#!#!#!###!!!!!!!!!!!!!!!!!###!#!###!###!#!##
#!!!!!!!!!#!!!!!!!#!#!#!!!!!#!#!!!!!!!!!#!!!!!!!!#
#!##!!#!##!!#!###!#!#!#!#!#!#!!!#!!!###!#!#####!!#
#!#!!!!!!!!!#!!!!!!!#!!!!!#!#!!!!!#!!!!!!!!!!!#!!#
#!#!#!#!#!#!!!#!!!#!!!#!#!#!#!#!#!!!#!#!#!#!#!!!##
##################################################