##################################################
#!!!!!!!!!!!#!!!#!!!#!!!#!#!!!#!!!!!#!!!#!#!!!!!!#
#!#!#!!!#!###!#!###!#!#!#!!##!#!#!###!#!#!#!!!#!##
#!#!!!#!!!!!!!#S!!#!#!#!#!#!!!#!!!#!!!!!#!!!!!#!!#
#!##!!##!##!#!#!#!#!#!#!#!#!###!!##!#####!###!#!##
#!#!#!#!!!!!!!!!#!#!#!!!!!#!!!!!!!!!#!#!#!!!#!!!!#
###!#!###!!##!###!#!####!!#!#!#!#!!!#!#!#!###!#!##
#!!!#!!!!!!!#!#!#!!!!!!!#!!!#!#!#!#!!!!!#!!!!!#!!#
#!!##!#####!#!#!!####!!!###!####!!#!!##!#!###!##!#
#!#!!!#!!!!!!!!!#!!!!!!!!!!!!!!!!!!!#!!!!!#!!!!!!#
#!#!#####!!!!!!!!!!!!!!!!!!!!!!!!##!#!#!######!###
#!!!!!!!!!#!#!!!#!#!!!#!!!#!!!#!#!!!!!#!#!!!#!!!!#
###!#!#####!#!#!!!###!##!!####!#!###!!###!#####!##
#!!!#!#!#!!!!!#!E!!!!!#!!!!!!!#!!!!!!!!!#!#!!!#!!#
####!!#!#!#!###!#######!#####!!!###!#!###!###!#!##
#!!!!!!!!!#!!!!!!!#!#!#!!!!!#!#!!!!!!!!!#!!!!!!!!#
#!##!!#!##!!#!###!#!#!#!#!#!#!!!#!!!###!#!#####!!#
#!#!!!!!!!!!#!!!!!!!#!!!!!#!#!!!!!#!!!!!!!!!!!#!!#
#!#!#!#!#!#!!!#!!!#!!!#!#!#!#!#!#!!!#!#!#!#!#!!!##
##################################################